111111111111111111111111111111111111
1P100010000000000000C000000000000001
1010101011111111111111111111111111C1
101010101000000000000000000000000101
101010101011111111111111111111110101
101C10101010000000000000000000010101
10101010101011111111111111111101C101
101010101010100000000000000001010101
101010101010101111111111111101010101
101010101010101C0000000000E101010101
1C101010101010000000C000000101010101
101010101010111111111111111101010101
1010100000X00000C0000000000001010101
101010101011111111111111111111010101
10101C101000000000C00000000000010101
101010101111111111111111111111110101
1010101000000000000000000C0000000101
101010111111111111111111111111111101
100010000000C00000C00000000000000001
111111111111111111111111111111111111