111111111111111
1C0C00000000P01
1CCC00000000001
1C0CE000000X001
100000000000001
111111111111111
